Species	Echolocation Emission Type	Diet
Aethalops_alecto	Non	frugivore
Ametrida_centurio	Nasal	frugivore
Anoura_geoffroyi	Nasal	nectarivore
Antrozous_dubiaquercus	Oral	insectivore
Antrozous_pallidus	Oral	insectivore
Artibeus_hartii	Nasal	frugivore
Artibeus_jamaicensis	Nasal	frugivore
Aselliscus_tricuspidatus	Nasal	insectivore
Balantiopteryx_io	Oral	insectivore
Balantiopteryx_plicata	Oral	insectivore
Balionycteris_maculata	Non	frugivore
Barbastella_barbastellus	Oral	insectivore
Barbastella_leucomelas	Oral	insectivore
Cardioderma_cor	Nasal	carnivorous
Carollia_brevicauda	Nasal	frugivore
Carollia_perspicillata	Nasal	frugivore
Centronycteris_centralis	Oral	insectivore
Centronycteris_maximiliani	Oral	insectivore
Centurio_senex	Nasal	frugivore
Chaerephon_leucogaster	Oral	insectivore
Chaerephon_pumilus	Oral	insectivore
Chiroderma_villosum	Nasal	frugivore
Chironax_melanocephalus	Non	frugivore
Choeronycteris_mexicana	Nasal	nectarivore
Chrotopterus_auritus	Nasal	carnivorous
Cistugo_lesueuri	Oral	insectivore
Coelops_frithii	Nasal	insectivore
Coleura_afra	Oral	insectivore
Cormura_brevirostris	Oral	insectivore
Corynorhinus_townsendii	Oral	insectivore
Craseonycteris_thonglongyai	Oral	insectivore
Cynomops_abrasus	Oral	insectivore
Cynopterus_brachyotis	Non	frugivore
Cynopterus_titthaecheilus	Non	frugivore
Desmodus_rotundus	Nasal	sanguivore
Diaemus_youngi	Nasal	sanguivore
Diclidurus_scutatus	Oral	insectivore
Diphylla_ecaudata	Nasal	sanguivore
Dobsonia_moluccensis	Non	frugivore
Dobsonia_praedatrix	Non	frugivore
Eidolon_helvum	Non	frugivore
Emballonura_alecto	Oral	insectivore
Emballonura_monticola	Oral	insectivore
Eonycteris_spelaea	Non	nectarivore
Epomophorus_wahlbergi	Non	frugivore
Epomops_franqueti	Non	frugivore
Eptesicus_fuscus	Oral	insectivore
Eumops_auripendulus	Oral	insectivore
Eumops_glaucinus	Oral	insectivore
Eumops_hansae	Oral	insectivore
Eumops_underwoodi	Oral	insectivore
Furipterus_horrens	Oral	insectivore
Glauconycteris_argentata	Oral	insectivore
Glauconycteris_variegata	Oral	insectivore
Glossophaga_soricina	Nasal	nectarivore
Hipposideros_armiger	Nasal	insectivore
Hipposideros_caffer	Nasal	insectivore
Hipposideros_commersoni	Nasal	insectivore
Hipposideros_fulvus	Nasal	insectivore
Hipposideros_pratti	Nasal	insectivore
Hipposideros_speoris	Nasal	insectivore
Hylonycteris_underwoodi	Nasal	nectarivore
Hypsignathus_monstrosus	Non	frugivore
Hypsugo_crassulus	Oral	insectivore
Kerivoula_minuta	Oral	insectivore
Lasionycteris_noctivagans	Oral	insectivore
Lasiurus_cinereus	Oral	insectivore
Lasiurus_intermedius	Oral	insectivore
Leptonycteris_curasoae	Nasal	nectarivore
Lonchophylla_robusta	Nasal	nectarivore
Lophostoma_brasiliense	Nasal	omnivore
Lophostoma_silvicolum	Nasal	omnivore
Macroderma_gigas	Nasal	carnivorous
Macroglossus_sobrinus	Non	nectarivore
Macrophyllum_macrophyllum	Nasal	insectivore
Macrotus_waterhousii	Nasal	insectivore
Megaderma_spasma	Nasal	insectivore
Megaerops_wetmorei	Non	frugivore
Mesophylla_macconnelli	Nasal	frugivore
Micronycteris_hirsuta	Nasal	insectivore
Micronycteris_megalotis	Nasal	insectivore
Micronycteris_minuta	Nasal	insectivore
Micropteropus_pusillus	Non	nectarivore
Mimon_crenulatum	Nasal	insectivore
Miniopterus_australis	Oral	insectivore
Miniopterus_inflatus	Oral	insectivore
Miniopterus_schreibersii	Oral	insectivore
Molossops_temminckii	Oral	insectivore
Molossus_molossus	Oral	insectivore
Molossus_rufus	Oral	insectivore
Mops_condylurus	Oral	insectivore
Mormoops_blainvillii	Oral	insectivore
Mormoops_megalophylla	Oral	insectivore
Mormopterus_planiceps	Oral	insectivore
Mosia_nigrescens	Oral	insectivore
Murina_leucogaster	Oral	insectivore
Myonycteris_angolensis	Non	frugivore
Myonycteris_relicta	Non	frugivore
Myotis_daubentonii	Oral	insectivore
Myotis_evotis	Oral	insectivore
Myotis_keenii	Oral	insectivore
Myotis_lucifugus	Oral	insectivore
Myotis_sodalis	Oral	insectivore
Myotis_velifer	Oral	insectivore
Myotis_yumanensis	Oral	insectivore
Mystacina_tuberculata	Oral	insectivore
Myzopoda_aurita	Oral	insectivore
Myzopoda_schliemanni	Oral	insectivore
Natalus_stramineus	Oral	insectivore
Neoromicia_capensis	Oral	insectivore
Neoromicia_nanus	Oral	insectivore
Noctilio_albiventris	Oral	insectivore
Noctilio_leporinus	Oral	carnivorous
Nyctalus_noctula	Oral	insectivore
Nycteris_arge	Nasal	insectivore
Nycteris_hispida	Nasal	insectivore
Nycteris_thebaica	Nasal	insectivore
Nycteris_tragata	Nasal	insectivore
Nycticeinops_schlieffeni	Oral	insectivore
Nycticeius_humeralis	Oral	insectivore
Nyctimene_albiventer	Non	frugivore
Nyctinomops_laticaudatus	Oral	insectivore
Nyctinomops_macrotis	Oral	insectivore
Nyctophilus_arnhemensis	Oral	insectivore
Otomops_martiensseni	Oral	insectivore
Paranyctimene_raptor	Non	frugivore
Penthetor_lucasi	Non	frugivore
Peropteryx_kappleri	Oral	insectivore
Peropteryx_trinitatis	Oral	insectivore
Phylloderma_stenops	Nasal	omnivore
Phyllostomus_elongatus	Nasal	omnivore
Phyllostomus_hastatus	Nasal	carnivorous
Pipistrellus_subflavus	Oral	insectivore
Platyrrhinus_dorsalis	Nasal	frugivore
Plecotus_auritus	Oral	insectivore
Ptenochirus_jagori	Non	frugivore
Pteronotus_davyi	Oral	insectivore
Pteronotus_parnellii	Oral	insectivore
Pteropus_poliocephalus	Non	frugivore
Pteropus_scapulatus	Non	frugivore
Pteropus_vampyrus	Non	frugivore
Rhinolophus_acuminatus	Nasal	insectivore
Rhinolophus_affinis	Nasal	insectivore
Rhinolophus_celebensis	Nasal	insectivore
Rhinolophus_clivosus	Nasal	insectivore
Rhinolophus_creaghi	Nasal	insectivore
Rhinolophus_darlingi	Nasal	insectivore
Rhinolophus_eloquens	Nasal	insectivore
Rhinolophus_euryale	Nasal	insectivore
Rhinolophus_ferrumequinum	Nasal	insectivore
Rhinolophus_fumigatus	Nasal	insectivore
Rhinolophus_hildebrandti	Nasal	insectivore
Rhinolophus_hipposideros	Nasal	insectivore
Rhinolophus_landeri	Nasal	insectivore
Rhinolophus_lepidus	Nasal	insectivore
Rhinolophus_luctus	Nasal	insectivore
Rhinolophus_macrotis	Nasal	insectivore
Rhinolophus_mehelyi	Nasal	insectivore
Rhinolophus_monoceros	Nasal	insectivore
Rhinolophus_philippinensis	Nasal	insectivore
Rhinolophus_pusillus	Nasal	insectivore
Rhinolophus_rex	Nasal	insectivore
Rhinolophus_rufus	Nasal	insectivore
Rhinolophus_sedulus	Nasal	insectivore
Rhinolophus_simulator	Nasal	insectivore
Rhinolophus_sinicus	Nasal	insectivore
Rhinolophus_swinnyi	Nasal	insectivore
Rhinolophus_thomasi	Nasal	insectivore
Rhinolophus_trifoliatus	Nasal	insectivore
Rhinonicteris_aurantia	Nasal	insectivore
Rhinophylla_pumilio	Nasal	frugivore
Rhinopoma_hardwickii	Nasal	insectivore
Rhinopoma_muscatellum	Nasal	insectivore
Rhogeessa_parvula	Oral	insectivore
Rhynchonycteris_naso	Oral	insectivore
Rousettus_aegyptiacus	Non	frugivore
Rousettus_amplexicaudatus	Non	frugivore
Rousettus_leschenaultii	Non	frugivore
Saccolaimus_flaviventris	Oral	insectivore
Saccopteryx_bilineata	Oral	insectivore
Saccopteryx_gymnura	Oral	insectivore
Saccopteryx_leptura	Oral	insectivore
Sauromys_petrophilus	Oral	insectivore
Scotoecus_hirundo	Oral	insectivore
Scotophilus_dinganii	Oral	insectivore
Scotophilus_kuhlii	Oral	insectivore
Sphaeronycteris_toxophyllum	Nasal	frugivore
Sturnira_lilium	Nasal	frugivore
Syconycteris_australis	Non	nectarivore
Tadarida_brasiliensis	Oral	insectivore
Taphozous_hildegardeae	Oral	insectivore
Taphozous_melanopogon	Oral	insectivore
Thyroptera_discifera	Oral	insectivore
Thyroptera_tricolor	Oral	insectivore
Tonatia_saurophila	Nasal	insectivore
Trachops_cirrhosus	Nasal	carnivorous
Triaenops_afer	Nasal	insectivore
Triaenops_persicus	Nasal	insectivore
Tylonycteris_robustula	Oral	insectivore
Uroderma_bilobatum	Nasal	frugivore
Vampyressa_pusilla	Nasal	frugivore
Vampyrum_spectrum	Nasal	carnivorous
Vielasia_sigei	unknown	unknown
Lionycteris_spurrelli	unknown	unknown